abase	abstruse	abridge	abject
abduction	abyss	absorb	abominable
abate	abusive	abscond	ablution
abase	abundant	abrogate	abjure
abdicate	abysmal	absolve	abolish
abbreviate	abut	absolute	abnegation
aberrant	academic	abstain	aboriginal
abet 	accede	abstemious	abortive
abeyance	abrade	abstinence	accelerate
abhor	abrasive	abstract	accentuate
@List 1
accessible	acquire	accoutre	adage
accord	acumen	acoustics	adept
acclaim	acrid	accrue	adapt
acclimate	acidulous	acerbity	accolade
acclivity	acrimonious	acrophobia	addendum
adapt	actuarial	acetic	addiction
accommodate	actuate	acknowledge	addle
accomplice	acuity	acme	address
accessory	acquittal	accretion	adamant
accost	acute	acquiesce	adhere
@List 2
affirmation	adversity	admonish	aggregate
affiliation	adversary	adjacent	agglomeration
affinity	adverse	adjunct	aggrandize
affront	aesthetic	adulation	agitate
affix	advocacy	admonition	aggressor
affliction	advocate	adorn	aghast
affluence	aerie	adroit	agility
affidavit	adventitious	adherent	agent
aftermath	affable	adulterate	agnostic
agenda	affected	advent	agrarian
@List 3
alias	amalgamate	allocate	amend
alchemy	altercation	alleviate	ameliorate
alcove	altruistic	alliteration	amenable
alimony	ambience	allude	amicable
alienate	amass	alloy	amenities
alimentary	ambidextrous	alloy	amiable
allegiance	amble	aloft	amnesia
allay	ambiguous	allure 	amiss
allege	ambivalence	allusion	amity
alacrity	aloof	allegory	ambulatory
@List 4
annihilate	anachronistic	anecdote	amnesty
anomalous	anarchy	animated	amphitheater
annuity	analogous	anesthetic	amorous
annul	analogy	anguish	amorphous
anoint	anarchist	angular	amphibian
anonymity	ancestry	animus	amplify
anomaly	anathema	animosity	ample
antagonism	ancillary	annex	amulet
anonymous	anchor	annals	amputate
annotate	analgesic	anemia	amoral
@List 5
apparatus	appall	aphorism	antidote
antediluvian	apparition	aplomb	antiquated
anthropocentric	append	apogee	apathy
anthem	appease	apocalyptic	antiseptic
anthology	appellation	apocryphal	antithesis
antecedents antecede	apiary	antipathy
anthropoid	application	apolitical	ape
anthropomorphic	appraise	apostate	apex
anthropologist	apposite	apologist	aperture
anticlimax	appreciate	apotheosis	aphasia
@List 6
arroyo	aristocracy	arcane	apropos
arrears	arduous	arbitrator	apprise
array	ardent	arbitrary	apprenticeship
articulate	aromatic	archaic	aquatic
arrest aria	arboretum approbation
arrogance	arid	arcade	appropriate
array	archives	arbiter	apprehension
arsenal	armada	archaeology	aptitude
arraign	archipelago	arable	apprehend
artifact	arousal	archetype	aquiline
@List 7
atavism	aspire	ascertain	assurance
astute	askance	artifice	assiduous
asymmetric	aspirant	ascendancy	assumption
atrophy	assessment	asinine	astronomical
atlas	assay	ascribe	astigmatism
atheistic	assail	ascetic	asteroid
asunder	askew	artisan	assimilate
atone	assent	aseptic	astral
atrocity	assert	ashen	astringent
asylum	asperity	artless	assuage
@List 8
aversion	auditory	attain	authoritative
avow	auroral	attribute	auxiliary
avocation	aureole	attribute	autopsy
awry	authenticate	audacious	avenge
avid	august	attest	autonomous
avert	augment	attentive	autocratic
avuncular	auspicious	attrition	avalanche
awe	austere	atypical	avarice
aviary	augury	attenuate	automaton
axiom	authoritarian	audit	averse
@List 9
baffle	beget	bate	bantering
bacchanalian	bedraggle	barterer	banal
bait	begrudge	bauble	barb
badger	beeline	bask	bandy
badinage	befuddle	bastion	bane
balk	behemoth	beam	baroque
azure	beatitude	barren	balm
baleful	beguile	bawdy	bard
babble	bedizen	barricade	balmy
ballast	belabor	beatific	barrage
@List 10
belated	beseech	beneficial	biased
belittle	besmirch	benign	biennial
belie	besiege	benevolent	bicker
bemoan	betoken	berate	bilk
bellicose	bestial	bent	bigotry
belligerent	bestow	bequeath	bilious
benediction	betroth	bereft	bivouac
bemused	betray	bereavement	billowing
beleaguer	beset	beneficiary	bicameral
benefactor	bevy	berserk	bizarre
@List 11
bolt	bluff	blandishment	bovine
bolster	bludgeon	bland	bourgeois
bolt	bluff	blare	bowdlerize
bombastic	blurt	blasphemy	braggart
bombardment	blunder	blasé	boycott
boisterous	bloated	blanch	bountiful
booming	bluster	blatant	brandish
boon	bode	bleak	bravado
boorish	bogus	blighted	brawn
boundless	bohemian	blithe	brazen
@List 12
bustle	bulwark	browbeat	calamity
bungalow	brunt	breadth	buxom
bungle	brusque	brevity	cabal
buoyant	buccaneer	brindled	cache
bumptious	browse	breach	buttress
burgeon	buffet	brittle	cadaver
bureaucracy	bucolic	bristling	cacophonous
burly	buffoonery	brochure	cadence
burnish	bullion	brooch	cajole
burlesque	buffet	broach	cadaverous
@List 13
calligraphy	carnal	caprice	canny
callous	carnivorous	capricious	cant
caliber	carnage	capitulate	canine
calorific	cartographer	captivate	cantata
calumny	cascade	carat	canter
callow	carping	caption	cantankerous
caldron	caricature	Capacity	candor
cameo	casualty	cardiologist	canvass
camaraderie	castigate	cardinal	canto
calculated	careen	capacious	camouflage
@List 14
cataclysm	cerebral	celerity	catholic
catalyst	cerebration	celestial	caucus
catastrophe	cessation	censorious	caustic
catcall	cession	censure	cavalcade
categorical	chaff	centrifugal	cavil
caterto	chaffing	centripetal	cede
catechism	chafe	centigrade	cavalier
cataract	certitude	censor	causal
catapult	ceremonious	celibate	caulk
catharsis	chagrin	centurion	celebrated
@List 15
chary	chronicle	chicanery	citadel
chasm	churlish	chide	cite
chassis	cipher	chimerical	Civil
Chaotic	choreography	check	circumspect
charisma	chortle	checkered	circumvent
charlatan	chronic	cherubic	cistern
champion	choleric	chauvinist	circumscribe
chameleon	Chivalrous	chastise	circumlocution
chaste	cipher	chisel	clairvoyant
chalice	chisel	chasten	circuitous
@List 16
clamber	clench	Clump	cognate
clangor	climactic	coalition	cohere
clandestine	clientele	coalesce	cognizance
claustrophobia	clique	codify	coin
clapper	clime	coddle	cohesion
clasp	Clip	codicil	coiffure
Cleft	Clout	cogent	colander
clemency	cloying	cogitate	collaborate
clamor	cliché	coagulate	cognitive
cleave	cloister	coercion	coincidence
@List 17
component	commandeer	compelling	collage
composure	commemorate	compensatory	collate
compress	commodious	complaisant	collusion
comprehensive	commiserate	complacency	colloquial
compromise	compact	complementary	comatose
comprise	communal	complement	colossal
compound	commensurate	compile	collateral
compunction	compact	compliance	combustible
compute	comparable	compliant	comely
concave	compatible	complicity	comeuppance
@List 18
contusion	concede	convex	cornucopia
conventional	concerted	convoke corpulent
converge	concession	convoluted	correlation
convention	conception	convivial	corporeal
converse	contrived	cordial	corrosive
conversant	conciliatory	Copious	corroborate
converse	concise	coquette	corrode
conundrum	conceit	conveyance	corollary
convene	concentric	conviction	coronation
convert	controvert	cordon	corrugated
@List 19
dauntless	curtail	countenance	debris
dawdle	cynical	countermand	debunk
daub	cursive	coterie	debilitate
daunt	cursory	countenance	debonair
deadpan	dabble	cumbersome	decadence
deadlock	cynosure	culvert	debutante
dapper	curator	Cosmic	debase
dappled	curmudgeon	cosmopolitan	debauch
dearth	dais	cumulative	decapitate
debacle	dank	cupidity	decelerate
@List 20
decollete	default	deflect	deign
decomposition	defeatist	defoliate	delectable
decipher	deface	defile	dehydrate
declivity	defame	definitive	deify
decrepit	defer	defunct	deliberate
decorum	defection	defray	delete
decoy	defer	deft	deleterious
deciduous	decry	deference	degenerate
decimate	deducible	defiance	degradation
decrepitude	defer	defuse	delineate
@List 21
deranged	demolition	depict	delirium
derelict	demoniac	deplete	delude
dermatologist	demystify	depose	delve
descant	denizen	depravity	demean
derivative	demure	deploy	delusion
derogatory	denigrate	deposition	demagogue
desecrate	denouement	depreciate	demented
descry	denotation	deprecate	demeanor
deride	demur	deplore	deluge
desiccate	denounce	depredation	demise
@List 22
desolate	devout	determination	discount
despondent	discomfit	detrimental	discrete
despise	diabolical	detonation	discredit
despoil	diagnosis	detraction	discrepancy
destitute	disconcert	devious	discriminating
despot	discomposure	deviate	discretion
desolate	dexterous	deterrent	discourse
desultory	disconsolate	devise	discursive
detached	discord	devoid	disdain
detergent	discordant	devotee	disembark
@List 23
disingenuous	disparate	dissuade	dissemble
disinter	disparity	distant	disseminate
disfigure	dislodge	dissident	dispel
disenfranchise	disinterested	dissent	dispassionate
disengage	disjointed	dissertation	dispatch
dishearten	dismember	dissolute	disputatious
disheveled	dismiss	dissolution	disquiet
disinclination	disparage	dissonance	dissection
disgorge	dismantle	dissimulate	disperse
disgruntle	dismay	dissipate	dispirited
@List 24
diva	downcast	domicile	doctrinaire
diverge	drab	domineer	doctrine
distinction	dossier	dogmatic	divest
distend	dormant	dogged	diversion
distill	dormer	doggerel	diversity
diurnal	dowdy	dolt	docile
distort	dote	doldrums	divine
distraught	douse	doleful	divulge
divergent	draconian	don	document
diverse	dregs	doodle	doff
@List 25
dross	effectual	eclectic	dutiful
drudgery	effervescence	eclipse	dwarf
drone	eerie	eccentricity	duration
ductile	effigy	economy	dynamic
droll	edify eccentric	duplicity
drone	efface	ecclesiastic	duress
dubious	efficacy	ecologist	dwindle
drivel edict	ebullient	dupe
dulcet	effrontery	ecstasy	earthy
dumbfound	effusive	eddy ebb
@List 26
egress	elucidate	embody	empirical
ejaculation	elusive	embrace	emulate
egregious	eloquence	embezzlement	empathy
elated	embroil	emanate	encipher
elegy	embryonic	emancipate	enclave
elaboration	embroider	emaciated	enamored
egoism ellipsis	embed	emissary
egotistical	elliptical	embellish	emollient
elicit	emendation	embargo	encomium
elixir	eminent	embark	encompass
@List 27
encroachment	engaging	ensconce	entrance
encumber	engender	ensemble	entreat
enduring	enigmatic	entice	eon
energize	enmity	entitlement	ephemeral
endorse	enthrall	enigma	enunciate
enfranchise	entomology	enormity	epicure
engage	entourage	enrapture	epigram
enervate	entity	ennui	epic
endearment	entail	engross	entrepreneur
endemic	enterprising	enhance	enumerate
@List 28
epilogue	equilibrium	erroneous	ethereal
eulogy	equity	eschew	epithet
euphemism	equivocal	esoteric	epitome
etymology	equitable	escapism	epitaph
episodic	equine	erudite	ethnic
epistolary	equinox	escapade	ethos
euphonious	equivocate	espionage	epoch
euphoria	erode	espouse	equable
evanescent	erotic	esteem	equanimity
evasive	erratic	estranged	equestrian
@List 29
evenhanded	excise	exertion	exotic
exacting	execute	expenditure	exigency
exalt	exegesis	expertise	exodus
ewe	exculpate	expedient	exhort
exacerbate	execrable	expedite	exhume
evince	exclaim	exhaustive	expansive
evocative	excoriate	exhilarating	expatriate
exasperate	exemplary	expiate	exonerate
exceptionable	exemplify	expletive	exorbitant
excerpt	exempt	explicate	exorcise
@List 30
explicit	exuberance	extenuate	faction
exploit	exude	extol	faculty 
exploit	exult	extort	fallacious
expunge	facetious	extricate	fanaticism
expurgate	facile	extrinsic	fancy
expropriate	facet	extrapolation	falter
exposure	façade	extraneous	fallow
extent	facsimile	extrude	farce
extant	facilitate	extrovert	fanfare
expository	fabricate	extradition	fallible
@List 31
fastidious	figment	fervid	feint
fatalism	figurative	fervor	felicitous
fawning	filial	fetter	felon
faze	filibuster	fiasco	feral
fauna	filch	fetid	fell
fathom	figurine	fester	felicity
fatuous	filament	festive	fell
feasible	finale	fickle	ferment
feign	finicky	fidelity	fervent
fecundity	finesse	fictitious	ferret
@List 32
flaccid	foment	fluctuate	flick
flag	foolhardy	fluency	flinch
fitful	foil	flourish	fleece
flabbergasted	foliage	flout	fleece
firebrand	fleck	florid	foible
fissure	fledgling	flounder	foil
flagrant	fop	fluke	flippant
flair	forbearance	fluster	flit
flamboyant	ford	flux	floe
flaunt	forebears	fodder	flora
@List 33
foreboding	forswear	fractious	fresco
forestall	fraternize	fortuitous	frivolous
forgo	fraudulent	forum	frolicsome
foresight	frantic	fortitude	frigid
forensic	forte	frail	fret
foreshadow	forthright	franchise	friction
forlorn	fraught	foster	frond
formality	fray	founder	frugality
formidable	frenetic	founder	fruition
forsake	frenzied	fracas	frustrate
@List 34
fugitive	gaffe	gamely	gaudy
furor	gall	garish	generality
fusion	galleon	garnish	generic
futile	galvanize	garrulous	genesis
gadfly	gambit	gauche	geniality
fulcrum	gainsay	gamut	gaunt
furtive	gall	garner	generate
fulsome. 	gait	gape	gavel
fundamental	galaxy	garbled	gawk
furlough	gale	gargantuan	genealogy
@List 35
genre	gibe	gloat	gorge
germane	gist	glower	gourmand
germinal	glut	glacial	gourmet
gentility	glossover	gingerly	gory
gentry	glossy	girth	gouge
genteel	glossary	giddy	gorge
germinate	glutton	glaring	graduated
gesticulation	gnarled	glaze	graft
ghastly	gnome	glib	grandeur
gibberish	goad	glimmer	grandiloquent
@List 36
grandiose	grievance	grueling	gusty
grate	grotesque	guile	hallowed
gratify	grouse	guileless	hallucination
gratuitous	hamper	gullible	grovel
granulate	grill	gruesome	hackneyed
graphic	grimace	gruff	haggard
gratis	halting	guise	grove
grapple	grisly	guffaw	haggle
gravity	haphazard	gustatory	grudging
gregarious	gruel	gusto	harangue
@List 37
harass	heckler	heterogeneous	hoary
harbinger	harrowing	heinous	hibernate
harbor	haughtiness	herbivorous	hierarchy
hardy	hazardous	heresy	hilarity
hedonist	heyday	hoax	homage
heed	hiatus	hodgepodge	homogeneous
heedless	hibernal	holster	hone
hazy	hermetic	headlong	hermitage
hindrance	hoodwink	headstrong	heterodox
histrionic	horde	hoard	horticultural
@List 38
host	hurtle	hovel	hybrid
hostility	husband	hover	hydrophobia
ichthyology	illicit	iconoclastic	illuminate
icon	illimitable	ideology	illusion
hypocritical	ignite	immaculate	illusory
hypothetical	ignoble	imminent	imbalance
Iax	ignominy	immobility	imbibe
humdrum	hue	hyperbole	idiom
humid	hulking	hypercritical	idiosyncrasy
humility	humane	hypochondriac	idolatry
@List 39
immune	impeach impending	impinge
immutable	impeccable	impenetrable	impious
impair	impecunious	impenitent	implacable
impale	impede	imperative	implausible
impalpable	impediment	Impervious	implement
impart	impel	impetuous	implicate
impartial	imperceptible	impertinent	implication
impassable	imperial	imperturbable	implicit
impasse	imperious	impetus	implore
impassive	impermeable	impiety	imply
@List 40
importunate	imprudent	incandescent	inchoate
incarcerate	incipient	incapacitate	incidental
incarnation	incisive	impregnable	inalienable
impotent	impunity	impromptu	inane
impoverished	inadvertently	incantation	incidence
importune	impudence	incendiary	incite
impostor	impugn	incense	inclement
impropriety	inanimate	incentive	incline
improvident	inarticulate	inception	inclined
improvise	inaugurate	incessant	inclusive
@List 41
incoherent	inculcate	incredulous	incontinent
incubate	incorrigible	inconsequential	incursion
indices	indissoluble	inconsistency	indefatigable
increment	incontrovertible	incrustation	incorporeal
incriminate	incorporate	incompatible	incumbent
indignation	indelible	incongruous	incur
indignity	indentation	indict	indoctrinate
indiscretion	indifferent	indenture	indolent
indiscriminate	indigenous indeterminate	indomitable
indisputable	indigent	indicative	indubitable
@List 42
ineffectual	infirmity	ingrained	inevitable
inefficacious	inflated	ingrate	inexorable
infuriate	induce	infer	inimical
infusion	indulgent	infernal	inimitable
inert	infraction	inhibit	infantile
inept	influx	ingratiate	infallible
inequity	informal	inherent	infamous
ingenious	industrious	infidel	iniquitous
ingenue	inebriated	infiltrate	initiate
ingenuous	ineffable	infinitesimal	injurious
@List 43
innuendo	insinuate	inkling	insatiable
innovation	insidious	instigate	intemperate
innovative	insightful	insubordination	inter
inquisitor	insolvent	inopportune	insipid
insalubrious	insomnia	inordinate	insolence
innate	inscrutable	integral	insuperable
innocuous	insensible	integrate	insurgent
insubstantial	interim	integrity	insurmountable
insularity	interloper	intellect	insurrection
insulated	interment	intelligentsia	intangible
@List 44
intricate	inviolable	intimate	inundate
intrinsic	invocation	intimidate	inured
introspective	invoke	intractable	invalidate
intrude	invulnerable	intransigence	invasive
intuition	iota	intrepid	invective
inverse	interminable	ironic	irascible
invert	intermittent	irony	irate
invidious	interrogate	irrational	ire
invigorate	intervene	irreconcilable	iridescent
invincible	intimacy	irrefutable	irksome
@List 45
itinerary	jaunt	irresolute	justification
jabber	jaunty	irretrievable	kaleidoscope
jaded	jeopardize	irreverence	kernel
jargon	jettison	irrevocable	killjoy
jaundiced	jingoist	itinerant	kindle
jocose	irrelevant	kindred	jubilation
jocular	irremediable	kinetic	judicious
jollity	irreparable	kleptomaniac	juncture
jostle	irrepressible	knave	junta
jovial	irreproachable	knit	jurisprudence
@List 46
knoll	laggard	levitate	lassitude
knotty	lament	levity	latent
kudos	lampoon	levy	lateral
laborious	languid	lewd	latitude
labyrinth	languish	lexicographer	laud
languor	legend	lavish	laceration
lap	legerdemain	leaven	lachrymose
larceny	leniency	lechery	lackadaisical
larder	lethal	leery	lackluster
largess	lethargic	legacy	laconic
@List 47
lexicon	liniment	limpid	libretto
liability	lionize	linchpin	licentious
liaison	liquidate	lineage	lilliputian
libel	list	linger	limber
liberator	listless	linguistic	limerick
loathe	lucid	litany	longevity
lofty	lucrative	lithe	loom
log	ludicrous	litigation	lope
loiter	lugubrious	livid	lout
loll	lull	loath	low
@List 48
lunar	malediction	luster	mammal
lunge	malefactor	lustrous	mammoth
lurid	malevolent	luxuriant	mandate
lurk	malfeasance	machinations	mandatory
luscious	malicious	madrigal	maniacal
malign	lull	maladroit	maelstrom
malignant	lumber	malady	magnanimous
malingerer	luminary	malaise	magnate
malleable	luminous	malapropism	magnitude
malodorous	lummox	malcontent	maim
@List 49
maritime	meditation	maudlin	manifest
marked	medley	maul	manifesto
marquee	meek	maverick	manipulate
marred	melancholy	mawkish	mannered
marshal	mellifluous	maxim	marital
meager	material	marsupial	membrane
meander	materialism	martial	memento
meddlesome	maternal	martinet	menagerie
mediate	matriarch	martyr	mendacious
mediocre	matriculate	masochist	mendicant
@List 50
mesmerize	microcosm	methodical	menial
metallurgical	migrant	meticulous	mentor
metamorphosis	migratory	metropolis	mercenary
metaphor	milieu	mettle	mercurial
metaphysical	militant	miasma	merger
mimicry	miserly	miscellany	mirage
mincin	misgivings	mischance	mire
minuscule	mishap	misconception	mirth
minute	misnomer	misconstrue	misanthrope
minutiae	misrepresent	misdemeanor	misapprehension
@List 51
monolithic	missile	mobile	moodiness
monosyllabic	missive	mock	moratorium
monotony	mite	mode	morbid
montage	mitigate	modicum	mores
monumental	mnemonic	modulate	moribund
molecule	motif	morose	momentum
mollify	motley	mortician	monarchy
molt	mottled	mortify	monastic
molten	muddle	mosaic	monetary
momentous	muggy	mote	monochromatic
@List 52
nadir	necromancy	nemesis	natty
naiveté	nefarious	neologism	nauseate
narcissist	negate	neophyte	nautical
narrative	negligence	nepotism	navigable
nascent	negligible	nettle	nebulous
mushroom	multifaceted	muted	mundane
musky	multifarious	mutinous	munificent
muster	multiform	myopic	mural
musty	multilingual	myriad	murky
mutability	multiplicity	mystify	muse
@List 53
nocturnal	nostalgia	nurture	obfuscate
noisome	notable	nutrient	obituary
nomadic	notoriety	oaf	objective
nomenclature	novelty	obdurate	objective
nominal	novice	obese	obligatory
oblique	noxious	nonchalance	neutral
obliterate	nuance	noncommittal	nicety
oblivion	nullify	nondescript	nihilist
oblivious	numismatist	nonentity	nip
obnoxious	nuptial	nonplus	nirvana
@List 54
oligarchy	obscure	opaque	offensive
ominous	obscure	opiate	offhand
omnipotent	obsequious	opportune	officious
omnipresent	obsessive	opportunist	ogle
omniscient	obsolete	optician	olfactory
obviate	omnivorous	obstetrician	optimist
odious	onerous	obstinate	optimum
odium	onset	obstreperous	optional
odorous	onus	obtrude	opulence
odyssey	opalescent	obtuse	opus
@List 55
ornithologist	oracular	ostensible	ordination
ornithology	orator	ostentatious	orgy
orthodox	ordain	ostracize	orient
oscillate	ordeal	oust	orientation
ossify	ordinance	outlandish	ornate
palatable	outmoded	pacifist	ovation
paleontology	outskirts	pacify	overbearing
palette	outspoken	pact	overt
pall	outstrip	paean	overwrought
palliate	outwit	painstaking	pachyderm
@List 56
paranoia	pallid	pariah	panacea
paraphernalia	palpable	parity	panache
paraphrase	palpitate	parochial	pandemic.
parasite	paltry	parody	pandemonium
parched	pan	paroxysm	pander
panegyric	partition	paradigm	parry
panoramic	passive	paradox	parsimony
pantomime	passport	paragon	partial
papyrus	pastiche	parallelism	partiality
parable	pastoral	paramount	partisan
@List 57
peccadillo	patent	pedestrian	patriarch
pecuniary	pathetic	pediatrician	patrician
pedagogy	pathological	peerless	patronize
pedant	pathos	pejorative	paucity
pedantic	patina	pellucid	pauper
perennial	penchant	peripheral	perceptive
perfidious	pendant	periphery	percussion
perforate	penitent	perjury	perdition
perfunctory	pensive	permeable	peregrination
perimeter	penury	permeate	peremptory
@List 58
persona	phobia	pessimism	piebald
personable	phoenix	petrify	piecemeal
perspicacious	phylum	petty	pied
pert	physiological	petulant	piety
pertinacious	picaresque	phenomena	pigment
pillage	pertinent	philanderer	pernicious
pine	perturb	philanthropist	perpetrate
pinnacle	peruse	philistine	perpetual
pious	pervasive	philology	perpetuate
piquant	perverse	phlegmatic	perquisite
@List 59
politic	pique	podiatrist	plausible
polygamist	pique	podium	plenitude
polyglot	pitfall	poignancy	plethora
pomposity	pithy	polarize	pliable
ponderous	pittance	polemical	pliant
pivotal	plight	plagiariz	pontifical
placate	plumage	plaintive	pore
placebo	plumb	plasticity	porous
placid	plummet	platitude	portend
plagiarism.	plutocracy	plaudit	portent
@List 60
portly	practicable	prank	potable
poseur	practical	prate	potent
posterity	practitioner	prattle	potentate
posthumous	pragmatic	preamble	potential
postulate	pragmatist	precarious	potion
predicament	precedent	precipitate	precocious
predilection	precept	precipitous	precursor
predispose	precinct	précis	predator
preeminent	precipice	precise	predecessor
preempt	precipitate	preclude	predetermine
@List 61
preternatural	prescience	premise	preen
pretext	presentiment	premonition	prehensile
prevail	prestige	preposterous	prelate
prevalent.	presumptuous	prerogative	prelude
prevaricate	pretentious	presage	premeditate
prey	privation	prod	profligate
prim	probe	prodigal	profound
primordial	problematic	prodigious	profusion
primp	proclivity	prodigy	progenitor
pristine	procrastinate	profane	progeny
@List 62
prostrate	propitiate	propulsive	protract
protean	propitious	prosaic	protrude
protégé	proponent	proscribe	protuberance
protocol	propound	proselytize	provident
prototype	propriety	prosperity	provincial
prolixity	propagate	promontory	prognosis
prologue	propellants	promote	projectile
prolong	propensity	prompt	proletarian
prominent	prophetic	promulgate	proliferation
promiscuous	propinquity	prone	prolific
@List 63
putrid	pundit	pseudonym	provisional
pyromaniac	pungent	psyche	provocative
quack	punitive	pterodactyl	provoke
quadruped	puny	puerile	prowess
quaff	purchase	pugilist	proximity
proxy	pugnacity	purge	quagmire
prude	pulchritude	purported	quail
prudent	pulverize	purse	quaint
prune	pummel	purveyor	qualified
prurient	punctilious	pusillanimous	qualms
@List 64
queasy	quirk	quorum	rankler
quell	quiver	rabid	rant
quench	quiver	raconteur	rapacious
querulous	quixotic	rail	rapport
query	quizzical	raiment	rapt
rampant	quorum	quibble	quandary
ramshackle	rabid	quiescent	quarantine
rancid	raconteur	quietude	quarry
rancord	rail	quintessence	quarry
random	raiment	quip	quay
@List 65
recumbent	reciprocal	rarefied	raze
recuperate	reciprocate	raspy	reactionary
recurrent	recluse	ratify	realm
redolent	reconcile	ratiocination	reaper
redoubtable	reconnaissance	rationale	rebuff
rationalize	rebuke	recast	recount
raucous	rebuttal	receptive	recourse
rave	recalcitrant	recession	recrimination
ravel	recant	recidivism	rectify
ravenous	recapitulate	recipient	rectitude
@List 66
refrain	relic	redress	remorse
refurbish	relinquish	redundant	remunerative
refute	relish	reek	rend
regal	remediable	refraction	render
regale	remedial	refractory	rendition
renegade	regime	reminiscence	rejoinder
renege	regimen	remiss	rejuvenate
renounce	rehabilitate	remission	relegate
renovate	reimburse	remnant	relent
renown	reiterate	remonstrance	relevant
@List 67
requite	ent	resigned	repress
rescind	reparable	resilient	reprieve
resentment	reparation	resolution	reprimand
reserve	repast	resolve	reprisal
residue	repeal	resolve	reprise
repel	reproach	replete	repulsion
repellent	reprobate	replica	reputable
repercussion	reprove	replicate	reputed
repertoire	repudiate	repository	requiem
replenish	repugnant	reprehensible	requisite
@List 68
restitution	retrieve	reverent	resonant
restive	retroactive	reverie	respiration
restraint	retrograde	revert	respite
resumption	retrospective	revile	resplendent
resurge	revelry	revoke	responsiveness
revulsion	retain	retiring	riddle
rhapsodize	retaliation	retort	rider
rhetoric	retentive	retract	rife
rhetorical	reticence	retrench	rift
ribald	retinue	retribution	rig
@List 69
rote	rigid	rummage	Sagacious
rotundity	rigor	ruse	sage
rousing	rigorous	rustic	salacious
routt	rile	ruthless	salient
rubblets	riveting	saboteur	salubrious
salutary	saccharine	rivulet	ruddy
salvage	sacrilegious	robust	rudimentary
salvo	sacrosanct	roil	rue
sanctimonious	sadistic	roster	ruffian
sanction	saga	rostrum	ruminate
@List 70
scenario	sanctuary	savor	scurry
schematic	sanguine	savory	scurvy
schism	sap	scabbard	scuttle
scintillate	sarcasm	scad	scuttle
scoff	sardonic	scaffold	seamy
sartorial	scale	scourge	satirical
sate	scamp	scruple	saturate
satellite	scanty	scrupulous	saturnine
satiate	scapegoat	scrutinize	saunter
satire	scavenge	scuffle	savant
@List 71
shimmer	serendipity	seedy	seasoned
shirk	serenity	seemly	secession
shoddy	serrated	seep	seclusion
shrewd	servile	seethe	secrete
shroud	servitude	seismic	sectarian
sever	seminary 	secular	shard
severity	sensual	sedate	sheaf
shackle	sententious	sedentary	shear
sham	sentinel	sedition	sheathe
shambles	sequester	sedulous	sheer
@List 72
slur	singular	shun	slag
smelt	sinister	shyster	slake
smirk	sinuous	sibling	slander
smolder	skeptic	simian	slapdash
snicker	skiff	simile	sleeper
sleight	simper	skimp	slough
slight	Simplistic	skinflint	slovenly
slipshod	simulate	skirmish	sluggard
slither	sinecure	skulk	sluggish
slothful	sinewy	slacken	slur
@List 73
somnolent	spartan	soporific	snivel
sonorous	spasmodic	sordid	sodden
sophisticated	spat	sovereign	sojourn
sophistry	spate	spangle	solacele
sophomoric	spatial	sparse	solder
solecism	sphinx-like	spatula	solitude
solemnity	splice	spawn	soluble
solicit	spontaneity	specious	solvent
solicitous	sporadic	spectrum	somber
soliloquy	sportive	spendthrift	somnambulist
@List 74
stalemate	stolid	stigma	spry
stalwart	stratagem	stigmatize	spurious
stamina	stratify	stilted	spurn
stanch	stratum	stint	squabble
stanza	strew	stint	squalor
squander	stellar	stipend	static
squat	stem	stipulate	statute
staccato	stemfrom	stodgy	steadfast
stagnant	stereotype	Stoic 	stealth
staid	stifle	stoke	steep
@List 75
strut	substantive	subpoena	striated
studied	subterfuge	subsequent	stricture
stultify	subtlety	subservient	strident
stupefy	subversive	subside	stringent
stupor	succinct	subsidiary	strut
succor	sublime	stymie	subsidy
succulent	subliminal	suavity	subsistence
succumb	submissive	subdued	substantial
suffragist	subordinate	subjective	substantiate
sully	suborn	subjugate	substantiate
@List 76
sustenance	supplant	surfeit	swathe
suture	supple	surly	swelter
swagger	supplicate	surmise	swerve
swarm	supposition	surmount	swill
swarthy	suppress	surpass	swindler
sultry	sybarite	surreptitious	supercilious
summation	sycophant	surrogate	superficial
summit	symbiosis	surveillance	superfluous
sumptuous	symmetry	susceptible	superimpose
sunder	synopticA	sustain	supersede
@List 77
tanner	tenacity	synthesis	tedious
tantalize	tendentious	table	temerity
tantamount	tender	tacit	temper
tantrum	tenet	taciturn	temperament
tarantula	tensile	tactile	temperate
tempestuous	taint	tenuous	tarry
tempo	talisman	tenure	taut
temporal	talon	tepid	tautological
temporiza	tangential	termination	tautology
tenacious	tangible	terminology	tawdry
@List 78
torrent	tirade	theocracy	terrestrial
torrid	titanic	theoreticall	terse
torso	title	therapeutic	testy
tortuous	titter	thermal	tether
totter	titular	thespian	thematic
threadbare	thwart	toady	touchstone
thrifty	tightwad	tome	touchy
thrive	tiller	tonic	tout
throes	timidity	topography	toxic
throng	timorous	torpor	tract
@List 79
treatise	truism	trinket	trepidation
trek	truncate	trite	trespass
tremor	trystg	trivial	tribute
tremulous	tumult	trough	trifling
trenchant	tundra	truculence	trigger
translucent	tractable	traumatic	transcribe
transmute	traduce	travail	transgression
transparent	trajectory	traverse	transient
transport	tranquillity	travesty	transition
trappings	transcendent	treacly	transitory
@List 80
unfathomable	unconscionable	turbid	tyro
unfetter	uncouth	turbulence	ubiquitous
unfrock	Unctuous	turgid	ulterior
ungainly	underlying	turmoil	ultimate
uniformity	undermine	turncoat	unaccountable
unanimity	turpitude	underscore	unimpeachable
unassailable	tutelage	undulating	uninhibited
unassuming	tycoon	unearth	unintimidating
unbridled	typhoon	unequivocal	unique
uncanny	tyranny	unerringly	universal
@List 81
unseemly	vanguard	unwieldy	valedictory
unsightly	vantage	unwitting	valid
unstinting	vapid	upbraid	validate
untenable	vaporize	upshot	valor
unwarranted	variegated	urbane	vampire
usurp	unkempt	veer	unprepossessing
utopia	unmitigated	vehement	unravel
vacuous	unobtrusive	velocity	unrequited
vagabond	unpalatable	venal	unruly
vagrant	unprecedented	vendetta	unscathed
@List 82
versatile	veracity	vendor	vigilance
vertex	verbalize	veneer	vignette
vertigo	verbatim	venerable	vigor
verve	verbiage	venerate	vilify
vestige	verbose	venial	vindicate
vindictive	venom	vex	verdant
viper	vent	viable	verge
virile	vent	vicarious	verisimilitude
virtual	ventriloquist	vicissitude	verity
virtue	venturesome	vie	vernacular
@List 83
wallow	vortex	virtuoso	vituperative
wan	vouchsafe	virulent	vivacious
wane	voyeur	virus	vociferous
wanton	vulnerable	visceral	vogua
warble	waffle	viscid	volatilea
viscous	volition	waft	warrant
vise	voluble	waggisha	warranty
visionary	voluminous	waifa	warya
vital	voluptuous	waive	wastrela
vitriolic	voracious	wake	watersheda
@List 84
wax	yield	withdrawn	wheedle
waylay	yield	wither	whelp
wean	yoke	withhold	whet
weather	yore	withstand	whiff
welter	zany	witless	whimsical
wrench	whinny	windfall	witticism
writhe	whittle	winnow	wizardry
wry	willful	winsome	woe.
xenophobia	wily	wispy	worldly
yen	wince	wistful	wrath
@List 85
zeal	zealot	zenith	zephyr
@List 86
